10 10
.%%%%%%%%%
.....%%..%
%%%%.%%%.%
%........%
%.%%%%%.%%
%.....%.%.
%%%%%.%.%.
..%.......
%.%.%.%%%%