10 10
.%%%%%%%%%
.....%%..%
%%%%.%%%.%
%........%%%..%.
%.%%%%%.%%
%.....%.%.
%%%%%.%.%.%%%..%.
..%.......
%.%.%.%%%%
....%.....