10 10
.%%%%%%%%%
.....%%..%
%%%%.%%%.%
%...*....%
%.%%%%%.%%
%.....%.%.
%%%%%.%.%.
..%.......
%.%.%.%%%%
....%.....