7 10
.%%%%%%%%%
.....%%..%
%%%%.%%%.%
%........%
%.%%%%%.%%
%.....%.%.
%%%%%%%...