101 61
..%%%%%%%%%%%%%%%%%%%%%%%%%%%%%%%%%%%%%%%%%%%%%%%%%%%%%%%%%%%
..%.......%.........%...%.%.%.%.....%.%.....%...%.%...%.....%
%.%%%%%.%%%.%.%%%%%.%.%%%.%.%.%%%.%%%.%.%.%%%.%%%.%%%.%.%%%%%
%.........%.%.%...............%.......%.%.%.......%.%...%...%
%.%%%%%%%%%%%%%%%%%%%%%%%.%%%.%.%.%.%%%%%.%.%%%.%%%.%%%.%.%.%
%...%.....%.%...%.........%.%...%.%...%.%.%.%.%.....%...%.%.%
%.%%%.%%%.%.%.%%%.%%%%%%%.%.%%%.%.%.%%%.%.%.%.%%%%%.%.%.%%%.%
%.....%.....%...%...%.%...%...%.%.%...%...%.%...%.....%.%...%
%.%.%%%%%.%.%.%.%.%.%.%.%%%.%.%%%%%.%.%.%%%%%.%%%%%.%%%.%%%.%
%.%...%.%.%.%.%.%.%...%.....%...%.%.%...%.%.....%.%...%.%...%
%%%.%.%.%.%.%%%.%%%.%.%%%.%%%%%.%.%.%%%.%.%.%%%.%.%.%%%%%.%.%
%...%...%.%.%.%.....%.%.%.%.......%.%...%.....%.%...%.....%.%
%.%.%.%.%%%.%.%%%.%.%.%.%%%%%%%.%%%.%%%%%%%%%.%%%.%%%.%.%%%.%
%.%.%.%.%.......%.%.%.....%.....%...%.%.%.....%.......%.%...%
%.%.%%%%%.%%%%%%%.%.%.%%%%%.%.%%%.%%%.%.%%%%%.%%%.%%%.%%%%%.%
%.%...%.%.....%...%.%...%.%.%.%...%.%.%...%.........%.....%.%
%.%%%%%.%%%.%.%%%.%.%%%%%.%.%%%%%.%.%.%%%.%.%.%%%%%%%%%%%%%%%
%.......%...%...%.%.%.......%...%.%.%.%...%.%.%.....%.%.....%
%.%.%%%.%%%%%.%.%%%.%%%%%.%.%.%%%.%.%.%%%.%%%.%.%.%%%.%%%.%.%
%.%.%.....%.%.%.......%.%.%.....%.%.%...%.%.....%.........%.%
%%%%%.%%%%%.%.%.%.%%%.%.%%%%%%%.%%%.%%%.%.%%%.%%%.%.%%%.%.%.%
%.....%.......%.%.%.......%...............%.%...%.%.%...%.%.%
%.%%%%%.%%%.%%%%%.%%%%%.%%%.%%%.%.%%%%%.%.%.%%%%%.%%%%%%%.%.%
%...%.....%.%.%.%.....%.%...%...%.%.%...%.......%...%.....%.%
%.%.%%%.%%%%%.%.%.%%%%%%%.%.%%%%%.%.%%%.%%%.%%%%%%%.%%%%%%%.%
%.%.%...%.%...%.....%...%.%.%.%.%.%.%...%.........%.%.......%
%%%%%%%.%.%.%.%.%%%.%.%.%%%.%.%.%%%.%.%%%%%.%%%%%%%%%.%%%.%%%
%.%.....%...%.%...%.%.%.%.%.....%...%.%.%.%.............%...%
%.%.%.%%%%%.%.%%%.%.%%%.%.%%%%%%%.%%%%%.%.%.%%%.%.%.%.%%%%%%%
%...%...%.%.%...%.%.%.....%...%.%.%.........%...%.%.%.%.%...%
%.%%%%%%%.%.%.%%%%%.%.%%%%%.%%%.%.%%%%%.%%%%%.%%%%%%%.%.%%%.%
%...%.....%.%.%.....%...%...%.%.%...%.....%.%.%...%.....%...%
%%%.%%%.%%%.%%%%%%%%%.%%%.%%%.%.%%%.%%%%%%%.%%%.%%%.%.%%%.%%%
%.%.%.......%.....%.......%.........%...............%.......%
%.%.%.%%%%%.%%%.%%%%%.%%%.%%%.%.%%%%%%%%%%%%%%%.%%%%%.%.%.%%%
%...%.%...%.....%...%.%.......%.%...%.....%.%.%.%.%.%.%.%.%.%
%.%.%%%%%.%%%.%%%.%%%.%.%.%%%%%.%.%%%%%.%.%.%.%.%.%.%%%%%.%.%
%.%.%...............%.%.%.%.......%.%...%.%...%.....%...%...%
%.%%%%%%%%%.%.%%%%%%%%%%%.%.%.%%%.%.%%%.%.%.%.%%%%%.%%%.%%%.%
%.....%...%.%.........%.%.%.%...%.%.....%...%.........%.%...%
%.%%%.%.%%%%%.%%%%%.%.%.%%%.%%%%%%%.%%%%%.%%%.%%%%%%%%%.%.%%%
%...%.%.........%...%...%.....%...%.%.......%.......%.%.....%
%.%.%%%.%.%.%.%.%.%%%%%.%.%.%%%%%.%.%%%%%%%.%.%.%.%.%.%.%.%%%
%.%...%.%.%.%.%.%.%.......%.%.%.....%.....%.%.%.%.%...%.%...%
%%%%%.%.%.%.%%%%%%%%%.%%%%%%%.%.%.%%%%%.%%%%%%%%%%%%%.%%%.%.%
%...%.%.%.%.......%.%.%.......%.%.%.%...%.......%.....%...%.%
%.%%%%%.%%%.%%%%%%%.%.%%%%%%%.%.%%%.%.%%%.%.%%%%%%%%%%%%%.%.%
%...%.....%...%.%.%...%.%.........%...%.%.%...%.........%.%.%
%.%%%.%%%%%.%%%.%.%.%%%.%.%.%%%%%%%.%.%.%%%%%.%.%.%.%.%.%%%%%
%.....%.......%...%.%...%.%.......%.%.......%...%.%.%.%...%.%
%%%.%%%.%%%.%%%%%.%.%.%.%%%.%.%%%%%.%.%%%%%%%%%%%%%.%%%.%%%.%
%...%...%...%.........%.....%.%.%...%.%...%.........%.....%.%
%%%.%%%%%%%%%.%.%.%%%%%%%.%%%.%.%.%.%%%.%.%.%%%.%%%%%%%%%.%.%
%.%...%...%.%.%.%.%.%.%...%.......%.....%...%.%.%.%.%.......%
%.%%%%%.%.%.%.%%%%%.%.%.%.%%%.%.%.%%%%%%%.%%%.%%%.%.%%%.%%%%%
%.....%.%...........%...%.%...%.%.....%...%...%.....%.%.%...%
%.%%%%%%%%%.%%%%%.%.%%%%%%%.%%%.%%%%%%%.%%%.%%%.%%%.%.%.%%%.%
%.....%.......%...%.%.....%.%...%...%.%.......%.%.%...%...%.%
%.%.%%%%%%%%%.%%%%%%%%%.%.%%%.%.%%%.%.%.%.%%%%%.%.%.%%%.%.%.%
%.%.......%.%.....%.%...%.....%.......%.%.........%.%.%.%...%
%.%%%%%.%.%.%.%%%%%.%%%%%.%.%%%%%.%%%.%%%%%%%.%%%.%%%.%%%%%.%
%...%...%...%.%.%.%.%.....%.%...%.%.%.....%.%...%.%.%.%.....%
%.%%%.%.%.%.%%%.%.%.%%%%%.%%%%%.%%%.%%%.%%%.%.%%%%%.%.%%%.%%%
%.%...%.%.%.%.......%...%...%.%...%.....%...%...%.%.%.%.....%
%.%%%%%%%%%%%.%.%.%%%.%%%%%%%.%.%.%.%.%%%%%.%.%%%.%.%.%%%.%%%
%.....%.....%.%.%.%.......%.....%...%.....%...%.%...%.%.%...%
%%%.%.%%%.%%%.%.%.%%%%%.%%%%%.%.%.%%%.%%%%%%%%%.%.%%%.%.%.%%%
%.%.%...%.....%.%.%...%.%.%...%.%...%.....%...%...%.%...%...%
%.%.%%%.%%%.%%%%%%%.%.%.%.%%%.%%%.%%%%%.%.%%%.%.%.%.%.%%%%%%%
%.....%...%...%.%...%.......%.%...%...%.%.......%...%.%...%.%
%.%%%%%.%%%.%.%.%.%%%%%.%.%%%%%%%.%%%.%.%%%.%%%.%.%%%.%.%.%.%
%.%.%.%.%.%.%.......%...%.%...........%.%.%.%...%.%.....%...%
%.%.%.%.%.%%%%%.%.%%%.%%%.%.%%%%%.%%%.%.%.%.%%%.%.%.%%%%%%%.%
%...%...%...%...%...%.%.....%.......%.%.%.%...%.%.%...%.%...%
%%%%%%%.%%%.%.%%%%%.%%%%%%%%%%%%%%%.%.%%%.%.%%%.%%%.%.%.%%%.%
%...............%...%.....%.......%.%.%.%.%.%.....%.%.%...%.%
%%%%%.%%%.%.%%%%%%%.%.%%%%%.%%%%%%%.%.%.%.%%%%%%%.%.%.%.%.%%%
%.....%...%...%...%.%.......%.......%.....%.....%.%.%...%...%
%%%%%%%.%%%%%.%.%%%%%.%.%%%%%.%%%%%%%%%%%.%%%.%%%%%.%%%%%.%%%
%.......%.........%...%.%.%.......%.%.%.%.....%.....%...%...%
%.%%%.%.%.%%%%%.%.%.%%%%%.%%%%%.%%%.%.%.%%%%%.%.%%%%%.%%%%%.%
%...%.%.%...%...%.....%.%.%.%.......%.....%.%.........%.....%
%%%%%%%%%.%.%.%.%%%.%.%.%.%.%%%%%%%.%%%.%%%.%%%.%.%%%%%%%.%.%
%.......%.%.%.%.%.%.%.%.....%...........%...%.%.%...%...%.%.%
%.%.%%%%%%%.%%%.%.%%%%%.%%%.%.%%%.%%%.%.%.%%%.%%%.%%%.%%%%%.%
%.%.%...%.%.%...%.%.....%.....%...%...%...%...%...%...%...%.%
%%%.%.%%%.%%%%%%%.%%%.%.%%%.%%%%%.%.%%%.%.%%%.%.%%%%%.%.%.%.%
%.........%.%.%.......%...%.....%.%...%.%.%...%.....%...%...%
%.%%%%%.%.%.%.%%%.%%%%%%%%%.%%%%%%%%%%%%%%%%%.%.%.%%%%%%%.%.%
%.....%.%.%.....%.%.....%...%.......%.........%.%...%...%.%.%
%.%.%%%%%%%.%.%.%%%%%.%%%%%.%.%%%%%%%%%%%%%%%.%%%%%%%%%.%.%%%
%.%.....%.%.%.%.....%.%.............%.%.%.....%.%...%...%...%
%%%.%%%%%.%.%.%.%.%.%.%%%.%.%%%%%%%.%.%.%%%.%%%.%%%.%%%.%.%.%
%.%.....%.%.%.%.%.%.%...%.%.%.%...%.....%.%.....%.......%.%.%
%.%.%%%.%.%.%%%%%%%%%.%.%%%%%.%.%%%.%.%%%.%%%.%%%.%%%.%.%%%.%
%...%.........%...%...%.%.....%.....%...%.....%.%.%.%.%.%...%
%%%%%.%%%.%.%.%%%.%.%%%%%.%%%%%%%.%%%.%.%.%.%%%.%%%.%%%.%.%.%
%.......%.%.%...%...%.%...........%.%.%...%...%.%.%.....%.%.%
%%%%%.%%%%%%%.%%%%%.%.%%%%%.%%%.%%%.%.%%%.%.%.%.%.%.%.%%%%%.%
%.....%.....................%.....%.....%.%.%...%...%........
%%%%%%%%%%%%%%%%%%%%%%%%%%%%%%%%%%%%%%%%%%%%%%%%%%%%%%%%%%%..