41 41
..%%%%%%%%%%%%%%%%%%%%%%%%%%%%%%%%%%%%%%%
..%.....%.............%...%...%...%.....%
%.%.%%%.%%%%%.%%%.%%%.%%%.%.%.%.%%%.%%%%%
%...%.........%...%...%.%...%.%...%.%...%
%%%.%.%.%.%%%.%%%%%%%.%.%%%.%%%.%.%.%.%%%
%.%.%.%.%.%.%.%.....%.%...%.....%...%...%
%.%.%.%%%.%.%%%.%%%%%.%.%%%.%.%%%.%.%.%.%
%.%.%.%.....%...........%...%.%.%.%.%.%.%
%.%.%%%.%.%%%%%.%.%%%.%%%%%%%%%.%.%%%.%%%
%...%...%...%...%.%.%...%.%...%.....%...%
%%%%%%%.%%%%%.%%%%%.%.%%%.%%%.%%%.%%%%%.%
%.........%.%.....%.....%...............%
%%%.%%%%%.%.%.%.%%%.%%%.%%%.%.%%%%%.%%%.%
%...%.....%.%.%.%...%.%...%.%...%.%.%...%
%.%%%.%%%.%.%.%%%.%%%.%%%.%.%%%%%.%.%.%%%
%...%.%.%.%.%.%.....%...%.%.%.%.....%...%
%%%%%%%.%%%.%%%.%%%.%.%.%.%%%.%.%%%%%%%.%
%.....%.%.%...%...%.%.%...%.....%...%...%
%.%.%.%.%.%%%.%%%%%%%%%%%.%.%%%.%.%%%%%%%
%.%.%.%.%.%...%...%.....%.....%.....%.%.%
%.%.%%%.%.%.%.%%%.%.%.%%%.%.%.%%%.%%%.%.%
%.%...%.....%.%.....%...%.%.%.%.........%
%%%%%.%.%.%.%%%.%%%.%%%.%.%%%%%%%.%%%%%.%
%...%.%.%.%...%.%...%...%.%.....%.%.....%
%%%.%.%.%%%.%.%%%.%%%%%.%.%.%.%.%%%.%.%%%
%.%.....%...%.....%.%.%...%.%.%.%...%...%
%.%.%%%.%.%.%.%%%.%.%.%.%%%%%.%%%.%%%%%%%
%...%...%.%.%...%...%.%...%.%.%.....%...%
%.%%%.%%%%%.%%%%%%%.%.%%%%%.%.%%%%%.%%%.%
%.%...%.....%...%.%...%...%.........%...%
%.%%%%%.%%%.%.%%%.%.%.%.%%%%%%%.%%%.%%%.%
%...%...%.%.....%...%.%.%.%...%...%.....%
%.%%%.%.%.%.%.%.%%%%%.%.%.%%%.%.%%%%%%%%%
%...%.%.%...%.%.%...%.%.......%...%.%...%
%.%.%%%%%.%%%.%.%.%.%.%%%%%.%%%.%%%.%%%.%
%.%.%...%...%.%...%.%.....%...%.......%.%
%%%.%.%%%.%%%.%%%%%%%%%%%.%.%%%.%%%.%%%.%
%...%...%.%...........%.......%.%.......%
%.%.%%%.%.%%%.%%%%%.%%%%%.%%%%%.%%%.%%%%%
%.%.%.......%.%.......%...%.....%........
%%%%%%%%%%%%%%%%%%%%%%%%%%%%%%%%%%%%%%%..